~~~~~~~~~~~~~~~~~~~~~~~~
~~~~~~~~~~~U~~~~~~~~~~~~
~~~~~~~~R~~UU~~~~~~~2~~~
~~~~~~~~~~~~U~~~~~~~~~~~
~~~~~UUUUUBBBBUUUUU~~~~~
~~~~~~~~~~H~~~~~~~~~~~~~
~~~~~~~~~~~~~H~~~~~~~~~~
~~~~~UUUUUBBBBUUUUU~~~~~
~~~~~~~~~~~U~~~~~~~~~~~~
~~~1~~~~~~~UU~~R~~~~~~~~
~~~~~~~~~~~~U~~~~~~~~~~~
~~~~~~~~~~~~~~~~~~~~~~~~
